NO ./cub/textures/zalij1.png
SO ./cub/textures/zalij2.png
EA ./cub/textures/zalij3.png
WE ./cub/textures/zalij3.png 

C 255, 0,0
F 0,0,255



        1111111111111111111111111
        1000000000110000000000001
        10110000011100000N0000001
        1001000000000000000000001
111111111011000001110000000000001
100000000011000001110111111111111
11110111111111011100000010001
11110111111111011101010010001
11000000110101011100000010001
10000000000000000000000000001
10000000000000001101010010001
1100000111010101111101111000111
11110111 1110101 1011110100011
11111111 1111111 11111111111