NO ./bonus/textures/zalij1.png
SO ./bonus/textures/zalij2.png
EA ./bonus/textures/zalij3.png
WE ./bonus/textures/zalij4.png

F 96,96,96
C 48, 133,195

1111111111
1000000011
1111110N01
1000000001
1111111111